Code;Year;Host;Bronze;Silver;Gold;GDP;Country_y;Elevation;Temperature;Gold First;London 1908;LOF;Exponential;Fibonacci;Total;Topend;Rank Gold First;Rank London 1908;Rank LOF;Rank Exponential;Rank Fibonacci;Rank Total;Rank Topend
AUS;1994;False;1;0;0;1339141.0;Australia;330.0;21.65;0.01;1;2;1;1;1;1;22;22;22;22;22;22;22
AUS;1998;False;1;0;0;1339141.0;Australia;330.0;21.65;0.01;1;2;1;1;1;1;23;23;23;23;23;22;23
AUS;2002;False;0;0;2;1339141.0;Australia;330.0;21.65;200.0;10;10;8;6;2;12;15;17;18;17;18;21;15
AUS;2006;False;1;0;1;1339141.0;Australia;330.0;21.65;100.01;6;7;5;4;2;7;17;18;18;18;18;19;18
AUS;2010;False;0;1;2;1339141.0;Australia;330.0;21.65;201.0;13;13;10;8;3;14;14;16;18;16;17;20;15
AUS;2014;False;1;2;0;1339141.0;Australia;330.0;21.65;2.01;7;8;5;5;3;5;23;22;22;23;22;22;23
AUT;1952;False;2;4;2;37695.0;Austria;910.0;6.35;204.02;24;26;18;16;8;22;5;4;4;5;4;4;5
AUT;1956;True;4;3;4;37695.0;Austria;910.0;6.35;403.04;33;37;26;22;11;34;2;2;2;2;2;2;2
AUT;1960;False;3;2;1;37695.0;Austria;910.0;6.35;102.03;14;17;11;10;6;13;9;8;7;8;7;7;8
AUT;1964;True;3;5;4;37695.0;Austria;910.0;6.35;405.03;38;41;29;25;12;37;2;3;3;3;3;3;2
AUT;1968;False;4;4;3;37695.0;Austria;910.0;6.35;304.04;31;35;24;21;11;30;6;5;4;5;4;4;5
AUT;1972;False;2;2;1;37695.0;Austria;910.0;6.35;102.02;13;15;10;9;5;12;8;9;8;8;9;8;8
AUT;1976;False;2;2;2;37695.0;Austria;910.0;6.35;202.02;18;20;14;12;6;18;6;6;6;6;6;7;6
AUT;1980;False;2;2;3;37695.0;Austria;910.0;6.35;302.02;23;25;18;15;7;24;4;5;6;4;6;6;4
AUT;1984;False;1;0;0;37695.0;Austria;910.0;6.35;0.01;1;2;1;1;1;1;16;16;16;16;16;15;16
AUT;1988;False;2;5;3;37695.0;Austria;910.0;6.35;305.02;32;34;24;21;10;30;6;4;4;4;4;4;4
AUT;1992;False;8;7;6;37695.0;Austria;910.0;6.35;607.08;59;67;46;40;21;58;4;4;4;4;4;3;4
AUT;1994;False;4;3;2;37695.0;Austria;910.0;6.35;203.04;23;27;18;16;9;22;9;9;8;9;8;8;9
AUT;1998;False;9;5;3;37695.0;Austria;910.0;6.35;305.09;39;48;31;28;17;37;8;7;5;6;6;4;7
AUT;2002;False;10;4;3;37695.0;Austria;910.0;6.35;304.1;37;47;30;27;17;36;10;7;5;6;6;5;8
AUT;2006;False;7;7;9;37695.0;Austria;910.0;6.35;907.07;73;80;57;48;23;75;3;3;3;3;4;4;3
AUT;2010;False;6;6;4;37695.0;Austria;910.0;6.35;406.06;44;50;34;30;16;42;9;6;6;6;6;5;6
AUT;2014;False;5;8;4;37695.0;Austria;910.0;6.35;408.05;49;54;37;33;17;45;9;7;7;7;7;7;7
BEL;1998;False;1;0;0;455086.0;Belgium;181.0;9.55;0.01;1;2;1;1;1;1;23;23;23;23;23;22;23
BGR;1980;False;1;0;0;50199.0;Bulgaria;472.0;10.55;0.01;1;2;1;1;1;1;17;17;17;17;17;16;17
BGR;1998;False;0;0;1;50199.0;Bulgaria;472.0;10.55;100.0;5;5;4;3;1;6;15;17;17;17;17;22;16
BGR;2002;False;2;1;0;50199.0;Bulgaria;472.0;10.55;1.02;5;7;4;4;3;4;20;20;20;20;20;17;20
BGR;2006;False;0;1;0;50199.0;Bulgaria;472.0;10.55;1.0;3;3;2;2;1;2;22;22;23;23;23;23;23
BLR;1994;False;0;2;0;54609.0;Belarus;160.0;6.15;2.0;6;6;4;4;2;4;15;16;19;18;17;19;19
BLR;1998;False;2;0;0;54609.0;Belarus;160.0;6.15;0.02;2;4;2;2;2;2;21;21;19;20;20;18;20
BLR;2002;False;1;0;0;54609.0;Belarus;160.0;6.15;0.01;1;2;1;1;1;1;23;23;23;23;23;23;23
BLR;2006;False;0;1;0;54609.0;Belarus;160.0;6.15;1.0;3;3;2;2;1;2;22;22;23;23;23;23;23
BLR;2010;False;1;1;1;54609.0;Belarus;160.0;6.15;101.01;9;10;7;6;3;9;17;19;20;19;20;20;18
BLR;2014;False;1;0;5;54609.0;Belarus;160.0;6.15;500.01;26;27;21;16;6;31;8;14;15;13;15;18;11
CAN;1952;False;1;0;1;1552808.0;Canada;487.0;-5.35;100.01;6;7;5;4;2;7;7;8;9;8;8;9;7
CAN;1956;False;2;1;0;1552808.0;Canada;487.0;-5.35;1.02;5;7;4;4;3;4;10;10;10;10;10;9;10
CAN;1960;False;1;1;2;1552808.0;Canada;487.0;-5.35;201.01;14;15;11;9;4;15;7;8;8;8;8;8;7
CAN;1964;False;1;1;1;1552808.0;Canada;487.0;-5.35;101.01;9;10;7;6;3;9;9;9;9;9;9;10;9
CAN;1968;False;1;1;1;1552808.0;Canada;487.0;-5.35;101.01;9;10;7;6;3;9;12;13;13;13;13;13;12
CAN;1972;False;0;1;0;1552808.0;Canada;487.0;-5.35;1.0;3;3;2;2;1;2;16;16;16;16;16;15;16
CAN;1976;False;1;1;1;1552808.0;Canada;487.0;-5.35;101.01;9;10;7;6;3;9;10;10;10;10;10;10;10
CAN;1980;False;1;1;0;1552808.0;Canada;487.0;-5.35;1.01;4;5;3;3;2;3;13;13;13;13;13;12;13
CAN;1984;False;1;1;2;1552808.0;Canada;487.0;-5.35;201.01;14;15;11;9;4;15;8;8;8;8;8;9;8
CAN;1988;False;3;2;0;1552808.0;Canada;487.0;-5.35;2.03;9;12;7;7;5;7;12;11;11;11;11;10;12
CAN;1992;False;2;3;2;1552808.0;Canada;487.0;-5.35;203.02;21;23;16;14;7;20;9;9;9;9;9;9;9
CAN;1994;False;4;6;3;1552808.0;Canada;487.0;-5.35;306.04;37;41;28;25;13;34;7;6;6;6;6;6;6
CAN;1998;False;4;5;6;1552808.0;Canada;487.0;-5.35;605.04;49;53;38;32;15;50;4;4;4;4;4;5;4
CAN;2002;False;7;3;7;1552808.0;Canada;487.0;-5.35;703.07;51;58;41;34;17;55;4;4;4;4;4;5;4
CAN;2006;False;7;10;7;1552808.0;Canada;487.0;-5.35;710.07;72;79;55;48;24;69;5;4;4;4;4;3;4
CAN;2010;False;5;7;14;1552808.0;Canada;487.0;-5.35;1407.05;96;101;75;61;26;103;1;3;3;2;3;3;1
CAN;2014;False;5;10;10;1552808.0;Canada;487.0;-5.35;1010.05;85;90;65;55;25;85;3;2;3;2;2;4;3
CHE;1952;False;2;0;0;67079.0;Switzerland;135.0;5.5;0.02;2;4;2;2;2;2;11;11;11;11;11;9;11
CHE;1956;False;1;2;3;67079.0;Switzerland;135.0;5.5;302.01;22;23;17;14;6;23;4;5;6;5;6;6;5
CHE;1960;False;0;0;2;67079.0;Switzerland;135.0;5.5;200.0;10;10;8;6;2;12;8;9;9;9;9;11;9
CHE;1968;False;4;2;0;67079.0;Switzerland;135.0;5.5;2.04;10;14;8;8;6;8;13;12;11;12;12;9;13
CHE;1972;False;3;3;4;67079.0;Switzerland;135.0;5.5;403.03;32;35;25;21;10;33;3;3;4;3;4;4;3
CHE;1976;False;1;3;1;67079.0;Switzerland;135.0;5.5;103.01;15;16;11;10;5;13;7;7;8;8;8;8;8
CHE;1980;False;3;1;1;67079.0;Switzerland;135.0;5.5;101.03;11;14;9;8;5;11;10;10;9;10;10;7;10
CHE;1984;False;1;2;2;67079.0;Switzerland;135.0;5.5;202.01;17;18;13;11;5;17;7;7;7;7;7;8;7
CHE;1988;False;5;5;5;67079.0;Switzerland;135.0;5.5;505.05;45;50;35;30;15;45;3;3;3;3;3;3;3
CHE;1992;False;2;0;1;67079.0;Switzerland;135.0;5.5;100.02;7;9;6;5;3;8;14;15;15;15;15;15;14
CHE;1994;False;2;4;3;67079.0;Switzerland;135.0;5.5;304.02;29;31;22;19;9;28;8;7;7;7;7;8;7
CHE;1998;False;3;2;2;67079.0;Switzerland;135.0;5.5;202.03;19;22;15;13;7;19;12;13;13;13;13;13;13
CHE;2002;False;6;2;3;67079.0;Switzerland;135.0;5.5;302.06;27;33;22;19;11;28;11;11;9;10;10;9;11
CHE;2006;False;5;4;5;67079.0;Switzerland;135.0;5.5;504.05;42;47;33;28;14;43;8;8;8;8;8;8;8
CHE;2010;False;3;0;6;67079.0;Switzerland;135.0;5.5;600.03;33;36;27;21;9;39;6;10;10;10;10;12;7
CHE;2014;False;2;3;6;67079.0;Switzerland;135.0;5.5;603.02;41;43;32;26;11;44;7;8;10;8;10;10;8
CHN;1992;False;0;3;0;11064665.0;China;184.0;6.95;3.0;9;9;6;6;3;6;15;13;15;15;14;15;15
CHN;1994;False;2;1;0;11064665.0;China;184.0;6.95;1.02;5;7;4;4;3;4;19;19;17;18;17;16;19
CHN;1998;False;2;6;0;11064665.0;China;184.0;6.95;6.02;20;22;14;14;8;14;16;12;13;14;11;12;14
CHN;2002;False;4;2;2;11064665.0;China;184.0;6.95;202.04;20;24;16;14;8;20;13;12;12;12;12;11;13
CHN;2006;False;5;4;2;11064665.0;China;184.0;6.95;204.05;27;32;21;19;11;25;14;11;11;11;11;10;13
CHN;2010;False;4;2;5;11064665.0;China;184.0;6.95;502.04;35;39;28;23;11;38;8;9;9;9;9;9;9
CHN;2014;False;2;4;3;11064665.0;China;184.0;6.95;304.02;29;31;22;19;9;28;13;12;12;12;12;12;13
DNK;1998;False;0;1;0;301308.0;Denmark;34.0;7.5;1.0;3;3;2;2;1;2;19;19;21;20;20;22;20
ESP;1972;False;0;0;1;1192901.0;Spain;660.0;13.3;100.0;5;5;4;3;1;6;13;14;15;14;15;15;14
ESP;1992;False;1;0;0;1192901.0;Spain;660.0;13.3;0.01;1;2;1;1;1;1;20;20;20;20;20;19;20
EST;2002;False;1;1;1;22459.0;Estonia;61.0;5.1;101.01;9;10;7;6;3;9;17;18;18;18;18;17;18
EST;2006;False;0;0;3;22459.0;Estonia;61.0;5.1;300.0;15;15;12;9;3;18;12;16;16;15;16;17;14
EST;2010;False;0;1;0;22459.0;Estonia;61.0;5.1;1.0;3;3;2;2;1;2;24;24;24;24;24;23;24
FIN;1952;False;2;4;3;232351.0;Finland;164.0;1.7;304.02;29;31;22;19;9;28;3;3;3;3;3;3;3
FIN;1956;False;1;3;3;232351.0;Finland;164.0;1.7;303.01;25;26;19;16;7;25;3;4;4;4;4;5;3
FIN;1960;False;3;3;2;232351.0;Finland;164.0;1.7;203.03;22;25;17;15;8;21;6;6;5;6;5;4;6
FIN;1964;False;3;4;3;232351.0;Finland;164.0;1.7;304.03;30;33;23;20;10;29;4;4;4;4;4;4;4
FIN;1968;False;2;2;1;232351.0;Finland;164.0;1.7;102.02;13;15;10;9;5;12;10;10;10;10;10;10;10
FIN;1972;False;1;4;0;232351.0;Finland;164.0;1.7;4.01;13;14;9;9;5;9;14;9;9;9;9;8;11
FIN;1976;False;1;4;2;232351.0;Finland;164.0;1.7;204.01;23;24;17;15;7;21;5;5;5;5;5;5;5
FIN;1980;False;3;5;1;232351.0;Finland;164.0;1.7;105.03;23;26;17;16;9;19;7;5;5;5;4;5;6
FIN;1984;False;6;3;4;232351.0;Finland;164.0;1.7;403.06;35;41;28;24;13;36;4;3;3;3;3;3;3
FIN;1988;False;2;1;4;232351.0;Finland;164.0;1.7;401.02;25;27;20;16;7;28;4;5;5;5;5;6;5
FIN;1992;False;3;1;3;232351.0;Finland;164.0;1.7;301.03;21;24;17;14;7;23;8;9;8;8;9;9;8
FIN;1994;False;5;1;0;232351.0;Finland;164.0;1.7;1.05;8;13;7;7;6;7;16;13;12;13;13;10;14
FIN;1998;False;6;4;2;232351.0;Finland;164.0;1.7;204.06;28;34;22;20;12;26;11;10;9;10;10;7;10
FIN;2002;False;1;2;4;232351.0;Finland;164.0;1.7;402.01;27;28;21;17;7;29;8;11;11;11;11;13;9
FIN;2006;False;3;6;0;232351.0;Finland;164.0;1.7;6.03;21;24;15;15;9;15;19;14;14;14;14;13;15
FIN;2010;False;4;1;0;232351.0;Finland;164.0;1.7;1.04;7;11;6;6;5;6;22;20;19;20;20;17;21
FIN;2014;False;1;3;1;232351.0;Finland;164.0;1.7;103.01;15;16;11;10;5;13;18;18;19;18;19;19;18
FRA;1952;False;1;0;0;2418836.0;France;375.0;10.7;0.01;1;2;1;1;1;1;13;13;13;13;13;12;13
FRA;1960;False;2;0;1;2418836.0;France;375.0;10.7;100.02;7;9;6;5;3;8;10;10;10;10;10;9;10
FRA;1964;False;0;4;3;2418836.0;France;375.0;10.7;304.0;27;27;20;17;7;26;5;6;6;6;6;7;6
FRA;1968;False;2;3;4;2418836.0;France;375.0;10.7;403.02;31;33;24;20;9;32;3;5;5;5;5;6;3
FRA;1972;False;2;1;0;2418836.0;France;375.0;10.7;1.02;5;7;4;4;3;4;15;14;13;14;13;12;15
FRA;1976;False;1;0;0;2418836.0;France;375.0;10.7;0.01;1;2;1;1;1;1;15;15;15;15;15;14;15
FRA;1980;False;1;0;0;2418836.0;France;375.0;10.7;0.01;1;2;1;1;1;1;17;17;17;17;17;16;17
FRA;1984;False;2;1;0;2418836.0;France;375.0;10.7;1.02;5;7;4;4;3;4;12;12;11;12;11;10;12
FRA;1988;False;1;0;1;2418836.0;France;375.0;10.7;100.01;6;7;5;4;2;7;10;13;14;13;14;14;12
FRA;1992;False;1;5;3;2418836.0;France;375.0;10.7;305.01;31;32;23;20;9;29;7;7;7;7;7;7;7
FRA;1994;False;4;1;0;2418836.0;France;375.0;10.7;1.04;7;11;6;6;5;6;17;14;14;14;14;12;16
FRA;1998;False;5;1;2;2418836.0;France;375.0;10.7;201.05;18;23;15;13;8;19;13;14;11;13;13;12;13
FRA;2002;False;2;5;4;2418836.0;France;375.0;10.7;405.02;37;39;28;24;11;36;6;7;8;8;8;9;8
FRA;2006;False;4;2;3;2418836.0;France;375.0;10.7;302.04;25;29;20;17;9;26;11;13;13;13;13;13;12
FRA;2010;False;6;3;2;2418836.0;France;375.0;10.7;203.06;25;31;20;18;11;24;13;12;11;12;11;9;13
FRA;2014;False;7;4;4;2418836.0;France;375.0;10.7;404.07;39;46;31;27;15;39;10;9;8;9;8;9;9
GBR;1952;False;0;0;1;2861091.0;United Kingdom;162.0;8.45;100.0;5;5;4;3;1;6;8;9;10;10;10;12;9
GBR;1964;False;0;0;1;2861091.0;United Kingdom;162.0;8.45;100.0;5;5;4;3;1;6;11;12;12;12;12;13;11
GBR;1976;False;0;0;1;2861091.0;United Kingdom;162.0;8.45;100.0;5;5;4;3;1;6;11;11;11;11;11;14;11
GBR;1980;False;0;0;1;2861091.0;United Kingdom;162.0;8.45;100.0;5;5;4;3;1;6;11;12;13;12;13;16;11
GBR;1984;False;0;0;1;2861091.0;United Kingdom;162.0;8.45;100.0;5;5;4;3;1;6;10;12;12;12;12;15;11
GBR;1994;False;2;0;0;2861091.0;United Kingdom;162.0;8.45;0.02;2;4;2;2;2;2;21;21;21;21;21;19;21
GBR;1998;False;1;0;0;2861091.0;United Kingdom;162.0;8.45;0.01;1;2;1;1;1;1;23;23;23;23;23;22;23
GBR;2002;False;1;0;1;2861091.0;United Kingdom;162.0;8.45;100.01;6;7;5;4;2;7;18;19;20;19;20;21;19
GBR;2006;False;0;1;0;2861091.0;United Kingdom;162.0;8.45;1.0;3;3;2;2;1;2;22;22;23;23;23;23;23
GBR;2010;False;0;0;1;2861091.0;United Kingdom;162.0;8.45;100.0;5;5;4;3;1;6;18;22;22;22;22;23;21
GBR;2014;False;2;1;1;2861091.0;United Kingdom;162.0;8.45;101.02;10;12;8;7;4;10;19;20;20;20;20;21;20
GER;1952;False;2;2;3;3363447.0;Germany;263.0;8.5;302.02;23;25;18;15;7;24;4;5;5;5;5;5;4
GER;1956;False;1;0;1;3363447.0;Germany;263.0;8.5;100.01;6;7;5;4;2;7;9;9;10;9;10;10;9
GER;1960;True;1;3;4;3363447.0;Germany;263.0;8.5;403.01;30;31;23;19;8;31;2;3;3;3;3;4;2
GER;1964;False;3;3;3;3363447.0;Germany;263.0;8.5;303.03;27;30;21;18;9;27;6;6;5;5;5;5;5
GER;1968;False;5;4;3;3363447.0;Germany;263.0;8.5;304.05;32;37;25;22;12;31;5;3;3;3;3;3;4
GER;1972;True;8;4;7;3363447.0;Germany;263.0;8.5;704.08;55;63;44;37;19;58;2;2;1;2;2;1;2
GER;1976;True;10;10;9;3363447.0;Germany;263.0;8.5;910.1;85;95;66;57;29;84;2;2;2;2;2;1;2
GER;1980;True;10;9;9;3363447.0;Germany;263.0;8.5;909.1;82;92;64;55;28;82;2;1;1;1;1;1;1
GER;1984;False;7;10;11;3363447.0;Germany;263.0;8.5;1110.07;92;99;71;60;28;93;1;1;1;1;1;1;1
GER;1988;True;8;14;11;3363447.0;Germany;263.0;8.5;1114.08;105;113;80;69;33;102;1;1;1;1;1;1;1
GER;1992;False;6;10;10;3363447.0;Germany;263.0;8.5;1010.06;86;92;66;56;26;86;1;1;1;1;1;1;1
GER;1994;False;8;7;9;3363447.0;Germany;263.0;8.5;907.08;74;82;58;49;24;76;3;3;3;3;3;2;3
GER;1998;False;8;9;12;3363447.0;Germany;263.0;8.5;1209.08;95;103;74;62;29;98;1;1;1;1;1;1;1
GER;2002;True;8;16;12;3363447.0;Germany;263.0;8.5;1216.08;116;124;88;76;36;112;2;1;1;1;1;1;1
GER;2006;False;6;12;11;3363447.0;Germany;263.0;8.5;1112.06;97;103;74;63;29;96;1;1;1;1;1;1;1
GER;2010;True;7;13;10;3363447.0;Germany;263.0;8.5;1013.07;96;103;73;63;30;93;2;3;2;3;2;2;3
GER;2014;False;5;6;8;3363447.0;Germany;263.0;8.5;806.05;63;68;49;41;19;65;6;6;6;6;6;6;6
HUN;1952;False;1;0;0;121715.0;Hungary;143.0;9.75;0.01;1;2;1;1;1;1;13;13;13;13;13;12;13
HUN;1956;False;1;0;0;121715.0;Hungary;143.0;9.75;0.01;1;2;1;1;1;1;13;13;13;13;13;12;13
HUN;1980;False;0;1;0;121715.0;Hungary;143.0;9.75;1.0;3;3;2;2;1;2;15;15;15;15;15;16;15
ITA;1952;False;1;0;1;1821497.0;Italy;538.0;13.45;100.01;6;7;5;4;2;7;7;8;9;8;8;9;7
ITA;1956;False;0;2;1;1821497.0;Italy;538.0;13.45;102.0;11;11;8;7;3;10;8;8;8;8;8;9;8
ITA;1960;False;1;0;0;1821497.0;Italy;538.0;13.45;0.01;1;2;1;1;1;1;14;14;14;14;14;14;14
ITA;1964;False;3;1;0;1821497.0;Italy;538.0;13.45;1.03;6;9;5;5;4;5;12;11;10;11;11;9;12
ITA;1968;False;0;0;4;1821497.0;Italy;538.0;13.45;400.0;20;20;16;12;4;24;4;9;9;8;9;12;8
ITA;1972;False;1;2;2;1821497.0;Italy;538.0;13.45;202.01;17;18;13;11;5;17;7;7;7;7;7;8;7
ITA;1976;False;1;2;1;1821497.0;Italy;538.0;13.45;102.01;12;13;9;8;4;11;9;9;9;9;9;9;9
ITA;1980;False;0;2;0;1821497.0;Italy;538.0;13.45;2.0;6;6;4;4;2;4;12;11;11;12;11;12;12
ITA;1984;False;0;0;2;1821497.0;Italy;538.0;13.45;200.0;10;10;8;6;2;12;9;10;10;10;10;12;9
ITA;1988;False;2;1;2;1821497.0;Italy;538.0;13.45;201.02;15;17;12;10;5;16;9;9;9;9;9;10;9
ITA;1992;False;4;6;4;1821497.0;Italy;538.0;13.45;406.04;42;46;32;28;14;40;6;5;5;5;5;5;6
ITA;1994;False;8;5;7;1821497.0;Italy;538.0;13.45;705.08;58;66;46;39;20;60;4;4;4;4;4;4;4
ITA;1998;False;2;6;2;1821497.0;Italy;538.0;13.45;206.02;30;32;22;20;10;26;10;9;10;10;10;10;10
ITA;2002;False;5;4;4;1821497.0;Italy;538.0;13.45;404.05;37;42;29;25;13;37;7;7;7;7;7;7;6
ITA;2006;False;6;0;5;1821497.0;Italy;538.0;13.45;500.06;31;37;26;21;11;36;9;10;10;10;10;10;10
ITA;2010;False;3;1;1;1821497.0;Italy;538.0;13.45;101.03;11;14;9;8;5;11;16;18;16;17;17;17;16
ITA;2014;False;6;2;0;1821497.0;Italy;538.0;13.45;2.06;12;18;10;10;8;10;21;19;18;19;19;15;20
JPN;1956;False;0;1;0;4383076.0;Japan;438.0;11.15;1.0;3;3;2;2;1;2;11;11;11;11;11;12;11
JPN;1972;False;1;1;1;4383076.0;Japan;438.0;11.15;101.01;9;10;7;6;3;9;10;11;11;11;11;12;11
JPN;1980;False;0;1;0;4383076.0;Japan;438.0;11.15;1.0;3;3;2;2;1;2;15;15;15;15;15;16;15
JPN;1984;False;0;1;0;4383076.0;Japan;438.0;11.15;1.0;3;3;2;2;1;2;14;14;15;14;14;15;14
JPN;1988;False;1;0;0;4383076.0;Japan;438.0;11.15;0.01;1;2;1;1;1;1;16;16;16;16;16;16;16
JPN;1992;False;4;2;1;4383076.0;Japan;438.0;11.15;102.04;15;19;12;11;7;14;11;10;10;10;10;9;11
JPN;1994;False;2;2;1;4383076.0;Japan;438.0;11.15;102.02;13;15;10;9;5;12;11;11;10;11;10;12;11
JPN;1998;False;4;1;5;4383076.0;Japan;438.0;11.15;501.04;32;36;26;21;10;36;7;8;8;8;8;10;8
JPN;2002;False;1;1;0;4383076.0;Japan;438.0;11.15;1.01;4;5;3;3;2;3;22;22;22;22;22;21;22
JPN;2006;False;0;0;1;4383076.0;Japan;438.0;11.15;100.0;5;5;4;3;1;6;18;19;20;19;20;23;19
JPN;2010;False;2;3;0;4383076.0;Japan;438.0;11.15;3.02;11;13;8;8;5;8;20;18;18;18;17;17;19
JPN;2014;False;3;4;1;4383076.0;Japan;438.0;11.15;104.03;20;23;15;14;8;17;17;17;17;17;17;15;17
KAZ;1994;False;0;2;1;184388.0;Kazakhstan;387.0;6.4;102.0;11;11;8;7;3;10;12;12;14;12;13;16;12
KAZ;1998;False;2;0;0;184388.0;Kazakhstan;387.0;6.4;0.02;2;4;2;2;2;2;21;21;19;20;20;18;20
KAZ;2010;False;0;1;0;184388.0;Kazakhstan;387.0;6.4;1.0;3;3;2;2;1;2;24;24;24;24;24;23;24
KAZ;2014;False;1;0;0;184388.0;Kazakhstan;387.0;6.4;0.01;1;2;1;1;1;1;24;24;24;24;24;24;24
KOR;1992;False;1;1;2;1377873.0;South Korea;282.0;11.5;201.01;14;15;11;9;4;15;10;11;11;11;11;12;10
KOR;1994;False;1;1;4;1377873.0;South Korea;282.0;11.5;401.01;24;25;19;15;6;27;6;8;9;8;9;10;8
KOR;1998;False;2;1;3;1377873.0;South Korea;282.0;11.5;301.02;20;22;16;13;6;22;9;12;13;11;13;14;11
KOR;2002;False;0;2;2;1377873.0;South Korea;282.0;11.5;202.0;16;16;12;10;4;16;14;14;15;14;14;15;14
KOR;2006;False;2;3;6;1377873.0;South Korea;282.0;11.5;603.02;41;43;32;26;11;44;7;9;9;9;9;10;7
KOR;2010;False;2;6;6;1377873.0;South Korea;282.0;11.5;606.02;50;52;38;32;14;50;5;5;5;5;5;7;5
KOR;2014;False;2;3;3;1377873.0;South Korea;282.0;11.5;303.02;26;28;20;17;8;26;14;14;13;14;13;15;15
LIE;1976;False;2;0;0;6664.0;Liechtenstein;;5.65;0.02;2;4;2;2;2;2;14;14;13;13;13;12;13
LIE;1980;False;0;2;2;6664.0;Liechtenstein;;5.65;202.0;16;16;12;10;4;16;6;8;8;8;8;9;8
LIE;1984;False;2;0;0;6664.0;Liechtenstein;;5.65;0.02;2;4;2;2;2;2;15;15;13;14;14;12;14
LIE;1988;False;1;0;0;6664.0;Liechtenstein;;5.65;0.01;1;2;1;1;1;1;16;16;16;16;16;16;16
LUX;1992;False;0;2;0;568.0;Luxembourg;325.0;8.65;2.0;6;6;4;4;2;4;16;16;17;16;16;17;16
LVA;2006;False;1;0;0;27003.0;Latvia;87.0;5.6;0.01;1;2;1;1;1;1;25;25;25;25;25;23;25
LVA;2010;False;0;2;0;27003.0;Latvia;87.0;5.6;2.0;6;6;4;4;2;4;21;21;21;22;21;21;22
LVA;2014;False;2;2;0;27003.0;Latvia;87.0;5.6;2.02;8;10;6;6;4;6;22;21;21;21;21;21;22
NED;1952;False;0;3;0;750284.0;Netherlands;30.0;9.25;3.0;9;9;6;6;3;6;9;6;6;6;6;7;9
NED;1960;False;1;1;0;750284.0;Netherlands;30.0;9.25;1.01;4;5;3;3;2;3;12;12;12;12;12;11;12
NED;1964;False;0;1;1;750284.0;Netherlands;30.0;9.25;101.0;8;8;6;5;2;8;10;10;11;10;11;11;10
NED;1968;False;3;3;3;750284.0;Netherlands;30.0;9.25;303.03;27;30;21;18;9;27;7;6;6;6;6;6;6
NED;1972;False;2;3;4;750284.0;Netherlands;30.0;9.25;403.02;31;33;24;20;9;32;4;4;5;4;5;5;4
NED;1976;False;3;2;1;750284.0;Netherlands;30.0;9.25;102.03;14;17;11;10;6;13;8;8;7;8;8;7;8
NED;1980;False;1;2;1;750284.0;Netherlands;30.0;9.25;102.01;12;13;9;8;4;11;9;9;10;10;10;9;10
NED;1988;False;2;2;3;750284.0;Netherlands;30.0;9.25;302.02;23;25;18;15;7;24;7;6;6;7;6;6;7
NED;1992;False;2;1;1;750284.0;Netherlands;30.0;9.25;101.02;10;12;8;7;4;10;12;12;12;12;12;12;12
NED;1994;False;3;1;0;750284.0;Netherlands;30.0;9.25;1.03;6;9;5;5;4;5;18;16;15;16;15;13;17
NED;1998;False;2;4;5;750284.0;Netherlands;30.0;9.25;504.02;39;41;30;25;11;40;6;7;7;7;7;8;6
NED;2002;False;0;5;3;750284.0;Netherlands;30.0;9.25;305.0;30;30;22;19;8;28;9;9;10;10;10;11;11
NED;2006;False;4;2;3;750284.0;Netherlands;30.0;9.25;302.04;25;29;20;17;9;26;11;13;13;13;13;13;12
NED;2010;False;3;1;4;750284.0;Netherlands;30.0;9.25;401.03;26;29;21;17;8;29;10;11;12;11;12;13;11
NED;2014;False;9;7;8;750284.0;Netherlands;30.0;9.25;807.09;70;79;55;47;24;71;5;5;5;5;5;5;5
NOR;1952;False;6;3;7;386578.0;Norway;460.0;1.5;703.06;50;56;40;33;16;54;1;1;1;1;1;1;1
NOR;1956;False;1;1;2;386578.0;Norway;460.0;1.5;201.01;14;15;11;9;4;15;7;7;7;7;7;7;7
NOR;1960;False;0;3;3;386578.0;Norway;460.0;1.5;303.0;24;24;18;15;6;24;4;4;6;5;5;7;5
NOR;1964;False;6;6;3;386578.0;Norway;460.0;1.5;306.06;39;45;30;27;15;36;3;2;2;2;2;2;3
NOR;1968;False;2;6;6;386578.0;Norway;460.0;1.5;606.02;50;52;38;32;14;50;1;1;1;1;1;1;1
NOR;1972;False;5;5;2;386578.0;Norway;460.0;1.5;205.05;30;35;23;21;12;27;6;5;4;5;4;3;5
NOR;1976;False;1;3;3;386578.0;Norway;460.0;1.5;303.01;25;26;19;16;7;25;4;4;4;4;4;5;4
NOR;1980;False;6;3;1;386578.0;Norway;460.0;1.5;103.06;20;26;16;15;10;18;8;6;5;6;6;4;7
NOR;1984;False;4;2;3;386578.0;Norway;460.0;1.5;302.04;25;29;20;17;9;26;6;6;6;6;6;4;6
NOR;1988;False;2;3;0;386578.0;Norway;460.0;1.5;3.02;11;13;8;8;5;8;11;10;10;10;10;10;10
NOR;1992;False;5;6;9;386578.0;Norway;460.0;1.5;906.05;68;73;53;44;20;71;3;3;3;3;3;4;3
NOR;1994;True;5;11;10;386578.0;Norway;460.0;1.5;1011.05;88;93;67;57;26;87;2;1;1;1;1;1;1
NOR;1998;True;5;10;10;386578.0;Norway;460.0;1.5;1010.05;85;90;65;55;25;85;2;2;2;2;2;2;2
NOR;2002;False;7;5;13;386578.0;Norway;460.0;1.5;1305.07;87;94;69;56;25;95;1;3;3;3;3;3;3
NOR;2006;False;9;8;2;386578.0;Norway;460.0;1.5;208.09;43;52;33;31;19;37;13;7;6;8;6;6;9
NOR;2010;False;6;8;9;386578.0;Norway;460.0;1.5;908.06;75;81;58;49;23;76;4;4;4;4;4;4;4
NOR;2014;True;10;5;11;386578.0;Norway;460.0;1.5;1105.1;80;90;64;53;26;86;2;3;3;3;4;3;2
NZL;1992;False;0;1;0;173754.0;New Zealand;388.0;10.55;1.0;3;3;2;2;1;2;17;18;18;18;18;19;18
POL;1956;False;1;0;0;477066.0;Poland;173.0;7.85;0.01;1;2;1;1;1;1;13;13;13;13;13;12;13
POL;1960;False;1;1;0;477066.0;Poland;173.0;7.85;1.01;4;5;3;3;2;3;12;12;12;12;12;11;12
POL;1972;False;0;0;1;477066.0;Poland;173.0;7.85;100.0;5;5;4;3;1;6;13;14;15;14;15;15;14
POL;2002;False;1;1;0;477066.0;Poland;173.0;7.85;1.01;4;5;3;3;2;3;22;22;22;22;22;21;22
POL;2006;False;1;1;0;477066.0;Poland;173.0;7.85;1.01;4;5;3;3;2;3;20;20;20;20;20;19;20
POL;2010;False;2;3;1;477066.0;Poland;173.0;7.85;103.02;16;18;12;11;6;14;15;14;14;14;14;15;15
POL;2014;False;1;1;4;477066.0;Poland;173.0;7.85;401.01;24;25;19;15;6;27;11;15;16;15;16;18;14
PRK;1964;False;0;1;0;12930.0;North Korea;400.0;5.7;1.0;3;3;2;2;1;2;13;13;13;13;13;13;13
PRK;1992;False;1;0;0;12930.0;North Korea;400.0;5.7;0.01;1;2;1;1;1;1;20;20;20;20;20;19;20
ROU;1968;False;1;0;0;177954.0;Romania;414.0;8.8;0.01;1;2;1;1;1;1;14;14;14;14;14;14;14
RUS;1956;False;6;3;7;1331208.0;Russian Federation;600.0;-5.1;703.06;50;56;40;33;16;54;1;1;1;1;1;1;1
RUS;1960;False;9;5;7;1331208.0;Russian Federation;600.0;-5.1;705.09;59;68;47;40;21;61;1;1;1;1;1;1;1
RUS;1964;False;6;8;11;1331208.0;Russian Federation;600.0;-5.1;1108.06;85;91;66;55;25;88;1;1;1;1;1;1;1
RUS;1968;True;3;5;5;1331208.0;Russian Federation;600.0;-5.1;505.03;43;46;33;28;13;43;2;2;2;2;2;2;2
RUS;1972;False;3;5;8;1331208.0;Russian Federation;600.0;-5.1;805.03;58;61;45;37;16;61;1;1;2;1;2;2;1
RUS;1976;False;8;6;13;1331208.0;Russian Federation;600.0;-5.1;1306.08;91;99;72;59;27;98;1;1;1;1;1;2;1
RUS;1980;False;6;6;10;1331208.0;Russian Federation;600.0;-5.1;1006.06;74;80;58;48;22;78;1;2;2;2;2;2;2
RUS;1984;True;9;10;6;1331208.0;Russian Federation;600.0;-5.1;610.09;69;78;53;47;25;65;2;2;2;2;2;2;2
RUS;1988;False;9;9;11;1331208.0;Russian Federation;600.0;-5.1;1109.09;91;100;71;60;29;93;2;2;2;2;2;2;2
RUS;1992;True;8;6;9;1331208.0;Russian Federation;600.0;-5.1;906.08;71;79;56;47;23;74;2;2;2;2;2;2;2
RUS;1994;False;4;8;11;1331208.0;Russian Federation;600.0;-5.1;1108.04;83;87;64;53;23;86;1;2;2;2;2;3;2
RUS;1998;False;3;6;9;1331208.0;Russian Federation;600.0;-5.1;906.03;66;69;51;42;18;69;3;3;3;3;3;3;3
RUS;2002;False;4;4;5;1331208.0;Russian Federation;600.0;-5.1;504.04;41;45;32;27;13;42;5;5;6;5;6;7;5
RUS;2006;False;8;6;8;1331208.0;Russian Federation;600.0;-5.1;806.08;66;74;52;44;22;68;4;5;5;5;5;5;5
RUS;2010;False;7;5;3;1331208.0;Russian Federation;600.0;-5.1;305.07;37;44;29;26;15;35;11;7;7;7;7;6;10
RUS;2014;False;9;11;13;1331208.0;Russian Federation;600.0;-5.1;1311.09;107;116;83;70;33;109;1;1;1;1;1;1;1
SWE;1952;False;4;0;0;495694.0;Sweden;320.0;2.1;0.04;4;8;4;4;4;4;10;10;7;10;8;6;10
SWE;1956;False;4;4;2;495694.0;Sweden;320.0;2.1;204.04;26;30;20;18;10;24;5;3;3;3;3;3;4
SWE;1960;False;2;2;3;495694.0;Sweden;320.0;2.1;302.02;23;25;18;15;7;24;5;5;5;5;5;5;5
SWE;1964;False;1;3;3;495694.0;Sweden;320.0;2.1;303.01;25;26;19;16;7;25;7;7;7;7;7;7;7
SWE;1968;False;3;2;3;495694.0;Sweden;320.0;2.1;302.03;24;27;19;16;8;25;8;7;7;7;7;7;7
SWE;1972;False;2;1;1;495694.0;Sweden;320.0;2.1;101.02;10;12;8;7;4;10;9;10;10;10;10;10;9
SWE;1976;False;2;0;0;495694.0;Sweden;320.0;2.1;0.02;2;4;2;2;2;2;14;14;13;13;13;12;13
SWE;1980;False;1;0;3;495694.0;Sweden;320.0;2.1;300.01;16;17;13;10;4;19;5;8;7;7;8;9;6
SWE;1984;False;2;2;4;495694.0;Sweden;320.0;2.1;402.02;28;30;22;18;8;30;5;5;5;5;5;6;5
SWE;1988;False;2;0;4;495694.0;Sweden;320.0;2.1;400.02;22;24;18;14;6;26;5;7;7;7;7;8;6
SWE;1992;False;3;0;1;495694.0;Sweden;320.0;2.1;100.03;8;11;7;6;4;9;13;14;13;13;14;12;13
SWE;1994;False;0;1;2;495694.0;Sweden;320.0;2.1;201.0;13;13;10;8;3;14;10;11;12;11;11;16;10
SWE;1998;False;1;2;0;495694.0;Sweden;320.0;2.1;2.01;7;8;5;5;3;5;17;16;16;16;16;16;17
SWE;2002;False;5;2;0;495694.0;Sweden;320.0;2.1;2.05;11;16;9;9;7;9;19;16;15;15;15;13;18
SWE;2006;False;5;2;7;495694.0;Sweden;320.0;2.1;702.05;46;51;37;30;14;51;6;6;7;6;7;8;6
SWE;2010;False;4;2;5;495694.0;Sweden;320.0;2.1;502.04;35;39;28;23;11;38;8;9;9;9;9;9;9
SWE;2014;False;6;7;2;495694.0;Sweden;320.0;2.1;207.06;37;43;28;26;15;32;15;10;10;10;10;9;10
TCH;1960;False;0;1;0;272420.0;Czech Republic-Slovakia;445.5;7.175;1.0;3;3;2;2;1;2;13;13;13;13;13;14;13
TCH;1964;False;1;0;0;272420.0;Czech Republic-Slovakia;445.5;7.175;0.01;1;2;1;1;1;1;14;14;14;14;14;13;14
TCH;1968;False;1;2;1;272420.0;Czech Republic-Slovakia;445.5;7.175;102.01;12;13;9;8;4;11;11;11;12;11;12;12;11
TCH;1972;False;2;0;1;272420.0;Czech Republic-Slovakia;445.5;7.175;100.02;7;9;6;5;3;8;11;12;12;12;12;12;12
TCH;1976;False;0;1;0;272420.0;Czech Republic-Slovakia;445.5;7.175;1.0;3;3;2;2;1;2;12;12;14;13;13;14;13
TCH;1980;False;1;0;0;272420.0;Czech Republic-Slovakia;445.5;7.175;0.01;1;2;1;1;1;1;17;17;17;17;17;16;17
TCH;1984;False;4;2;0;272420.0;Czech Republic-Slovakia;445.5;7.175;2.04;10;14;8;8;6;8;11;10;9;10;9;7;10
TCH;1988;False;2;1;0;272420.0;Czech Republic-Slovakia;445.5;7.175;1.02;5;7;4;4;3;4;14;14;14;14;14;13;14
TCH;1992;False;3;0;0;272420.0;Czech Republic-Slovakia;445.5;7.175;0.03;3;6;3;3;3;3;18;18;17;17;17;15;17
TCH;1998;False;1;1;1;272420.0;Czech Republic-Slovakia;445.5;7.175;101.01;9;10;7;6;3;9;14;15;15;15;15;16;15
TCH;2002;False;0;2;1;272420.0;Czech Republic-Slovakia;445.5;7.175;102.0;11;11;8;7;3;10;16;16;16;17;16;17;16
TCH;2006;False;1;3;1;272420.0;Czech Republic-Slovakia;445.5;7.175;103.01;15;16;11;10;5;13;15;16;15;16;15;15;16
TCH;2010;False;5;1;3;272420.0;Czech Republic-Slovakia;445.5;7.175;301.05;23;28;19;16;9;25;12;13;13;13;13;12;12
TCH;2014;False;2;4;3;272420.0;Czech Republic-Slovakia;445.5;7.175;304.02;29;31;22;19;9;28;13;12;12;12;12;12;13
UKR;1994;False;1;0;1;90615.0;Ukraine;175.0;8.3;100.01;6;7;5;4;2;7;13;16;17;16;17;19;14
UKR;1998;False;0;1;0;90615.0;Ukraine;175.0;8.3;1.0;3;3;2;2;1;2;19;19;21;20;20;22;20
UKR;2006;False;2;0;0;90615.0;Ukraine;175.0;8.3;0.02;2;4;2;2;2;2;24;24;21;23;23;19;23
UKR;2014;False;1;0;1;90615.0;Ukraine;175.0;8.3;100.01;6;7;5;4;2;7;20;23;23;23;23;23;21
USA;1952;True;1;6;4;18036648.0;United States;760.0;8.55;406.01;39;40;29;25;11;37;2;2;2;2;2;2;2
USA;1956;False;2;3;2;18036648.0;United States;760.0;8.55;203.02;21;23;16;14;7;20;6;6;6;6;6;5;6
USA;1960;False;3;4;3;18036648.0;United States;760.0;8.55;304.03;30;33;23;20;10;29;3;3;2;3;2;2;3
USA;1964;False;4;2;1;18036648.0;United States;760.0;8.55;102.04;15;19;12;11;7;14;8;8;8;8;8;7;8
USA;1968;False;1;5;1;18036648.0;United States;760.0;8.55;105.01;21;22;15;14;7;17;9;8;8;9;8;8;9
USA;1972;False;3;2;3;18036648.0;United States;760.0;8.55;302.03;24;27;19;16;8;25;5;6;6;6;6;6;6
USA;1976;False;4;3;3;18036648.0;United States;760.0;8.55;303.04;28;32;22;19;10;28;3;3;3;3;3;3;3
USA;1980;False;2;4;6;18036648.0;United States;760.0;8.55;604.02;44;46;34;28;12;46;3;3;3;3;3;3;3
USA;1984;False;0;4;4;18036648.0;United States;760.0;8.55;404.0;32;32;24;20;8;32;3;4;4;4;4;6;4
USA;1988;False;3;1;2;18036648.0;United States;760.0;8.55;201.03;16;19;13;11;6;17;8;8;8;8;8;8;8
USA;1992;False;2;4;5;18036648.0;United States;760.0;8.55;504.02;39;41;30;25;11;40;5;6;6;6;6;6;6
USA;1994;False;2;5;6;18036648.0;United States;760.0;8.55;605.02;47;49;36;30;13;48;5;5;5;5;5;6;5
USA;1998;False;4;3;6;18036648.0;United States;760.0;8.55;603.04;43;47;34;28;13;46;5;5;6;5;6;6;5
USA;2002;False;11;13;10;18036648.0;United States;760.0;8.55;1013.11;100;111;77;67;34;97;3;2;2;2;2;2;2
USA;2006;True;7;9;9;18036648.0;United States;760.0;8.55;909.07;79;86;61;52;25;79;2;2;2;2;2;2;2
USA;2010;False;13;15;9;18036648.0;United States;760.0;8.55;915.13;103;116;79;70;37;97;3;1;1;1;1;1;2
USA;2014;False;12;7;9;18036648.0;United States;760.0;8.55;907.12;78;90;62;53;28;80;4;4;3;4;4;2;4
UZB;1994;False;0;0;1;66733.0;Uzbekistan;;12.05;100.0;5;5;4;3;1;6;14;19;20;18;20;22;16
YUG;1984;False;0;1;0;91507.0;Croatia-Slovenia;411.5;9.9;1.0;3;3;2;2;1;2;14;14;15;14;14;15;14
YUG;1988;False;1;2;0;91507.0;Croatia-Slovenia;411.5;9.9;2.01;7;8;5;5;3;5;13;12;12;13;12;13;13
YUG;1994;False;3;0;0;91507.0;Croatia-Slovenia;411.5;9.9;0.03;3;6;3;3;3;3;20;20;19;20;20;16;20
YUG;2002;False;1;1;3;91507.0;Croatia-Slovenia;411.5;9.9;301.01;19;20;15;12;5;21;12;13;13;13;13;14;12
YUG;2006;False;0;2;1;91507.0;Croatia-Slovenia;411.5;9.9;102.0;11;11;8;7;3;10;16;17;17;17;17;17;17
YUG;2010;False;2;4;0;91507.0;Croatia-Slovenia;411.5;9.9;4.02;14;16;10;10;6;10;19;15;15;16;15;15;17
YUG;2014;False;4;3;2;91507.0;Croatia-Slovenia;411.5;9.9;203.04;23;27;18;16;9;22;16;16;15;16;15;12;16
